60 10 60 40
1 1 1 1 1 1 1 1 1 1
0 0 0 0 0 0 0 0 0 1
0 0 0 0 0 0 0 0 0 1
0 0 0 0 0 0 0 0 0 1
1 1 1 1 1 1 0 0 0 1
1 0 0 0 0 0 0 0 0 1
1 0 0 0 0 0 0 0 0 1
1 0 0 1 1 1 1 1 1 1
1 0 0 0 0 0 0 0 0 1
1 0 0 0 0 0 0 0 0 1
1 1 1 1 1 0 0 0 0 1
1 0 0 0 0 0 0 0 0 1
1 0 0 0 0 0 0 0 0 1
1 0 0 0 1 1 1 0 0 1
1 0 0 0 1 0 0 0 0 1
1 0 0 1 1 0 0 0 0 1
1 0 0 0 1 0 0 5 0 1
1 0 0 0 1 0 0 0 0 1
1 1 0 0 1 0 0 0 0 1
1 0 0 0 1 0 5 0 0 1
1 0 0 0 1 0 0 0 0 1
1 0 0 1 1 0 0 0 0 1
1 0 0 0 1 0 0 5 0 1
1 0 0 0 1 0 0 0 0 1
1 1 0 0 1 0 0 0 0 1
1 0 0 0 1 1 1 0 0 1
1 0 0 0 1 0 0 0 0 1
1 0 0 1 1 0 0 0 0 1
1 0 0 0 1 0 0 0 0 1
1 0 0 0 1 1 1 0 0 1
1 1 0 0 1 0 0 0 0 1
1 0 0 0 1 0 0 0 0 1
1 0 0 0 1 0 0 0 1 1
1 0 0 1 1 0 0 0 0 1
1 0 0 0 1 2 0 0 0 1
1 0 0 0 1 1 1 0 0 1
1 1 0 0 1 0 0 0 0 1
1 0 0 0 1 0 0 0 1 1
1 0 0 0 1 0 0 0 0 1
1 0 0 1 1 0 0 0 0 1
1 0 0 0 1 2 1 0 0 1
1 0 0 0 0 0 0 0 0 1
1 1 0 0 0 0 0 0 0 1
1 0 0 0 0 0 0 0 0 1
1 0 0 1 1 2 1 1 1 1
1 0 0 0 0 0 0 0 0 1
1 0 0 0 0 0 0 0 0 1
1 1 1 1 1 1 0 0 0 1
1 0 0 0 0 0 0 0 0 1
1 0 0 0 0 0 0 0 0 1
1 0 0 1 1 1 1 0 0 1
1 0 0 0 0 0 0 0 0 1
1 0 0 0 0 0 0 0 0 1
1 1 1 0 0 0 0 1 1 1
1 0 0 0 0 0 0 0 0 1
1 0 0 0 0 0 0 0 0 1
1 0 0 1 1 1 1 0 0 1
1 0 0 0 0 0 0 0 0 1
1 0 3 0 0 0 0 0 0 1
1 1 1 1 0 0 1 1 1 1
15
30 2400 30 30 2500 0
60 2400 60 30 2500 0
90 2400 90 30 2500 0
120 2400 120 30 2500 0
150 2400 150 30 2500 0
180 2400 180 30 2500 0
210 2400 210 30 2500 0
240 2400 240 30 2500 0
30 1620 240 1620 100 0
30 1560 240 1560 100 0
240 1490 30 1490 100 0
180 720 180 900 100 0
120 30 120 180 100 0
150 30 150 180 100 0
180 30 180 180 100 0
0
0
0
0

