10 10 120 200
1 1 1 1 1 0 0 0 0 1
0 0 0 0 1 0 0 0 0 1
0 0 0 0 1 1 1 0 0 1
0 0 0 0 1 0 0 0 0 1
1 1 0 0 1 0 0 0 0 1
1 0 0 0 1 0 0 0 0 1
1 0 0 0 0 0 1 1 1 1
1 0 0 0 0 0 5 0 0 1
1 0 0 0 0 0 5 0 0 1
1 1 1 1 1 1 1 1 1 1
0
0
0
0
1
8 4 3
